####.&.......##
####.&&&&&&&.##
####.......&.##
##########.&.##
#..........&.##
#.&&&&&&&&&&.##
#.&..........##
#.&############
#.&.....##%%###
#.&&&&&&&&%%###
#.......##%%###
###############

